10x20
***********O********
* R       *      R *
*                  *
*                  O
* * +     H      * *
*  R      +        O
*         +     R  *
*         +     +++*
* R       *      R *
*********O**********