10x20
*********O**********
*  R        R      *
*   R +  *  *      *
*        H  *      *
*   **     *   *   *
*  R*      *  +    *
*     ++     R  *  *
*  *           **  *
*     R      *     O
*O******************