7x10
**********
*  R  * +*
* R     +*
*     H  O
**+     +*
*R*  R   *
**********